K,K,K,K,K,K,K,K,K,K,K,K,K,K,K,K,K,K,K
K,A,0,0,A,0,0,0,A,0,A,0,0,0,A,0,0,A,K,
K,A,0,0,A,0,0,0,A,0,A,0,0,0,A,0,0,A,K,
K,A,A,A,A,A,A,A,A,A,A,A,A,A,A,A,A,A,K,
K,A,0,0,A,0,A,0,0,0,0,0,A,0,A,0,0,A,K,
K,A,A,A,A,0,A,A,A,0,A,A,A,0,A,A,A,A,K,
K,0,0,0,A,0,0,0,Y,0,Y,0,0,0,A,0,0,0,K,
X,X,X,0,A,0,Y,Y,Y,Y,Y,Y,Y,0,A,0,X,X,K,
K,0,0,0,A,0,Y,0,0,U,0,0,Y,0,A,0,0,0,K,
Y,Y,Y,Y,A,Y,Y,0,S,S,S,S,0,Y,Y,A,Y,Y,K,
F